schmale_streifen/cstpw1.xml	stripes
schmale_streifen/cstpw2.xml	stripes
schmale_streifen/cstpw3.xml	stripes
schmale_streifen/cstpw4.xml	stripes
schmale_streifen/cstpw5.xml	stripes
schmale_streifen/cstpw6.xml	stripes
schmale_streifen/cstpw7.xml	stripes
schmale_streifen/cstpw8.xml	stripes
schmale_streifen/cstpw9.xml	stripes
schmale_streifen/cstpw10.xml	stripes
schmale_streifen/cstpw11.xml	stripes
schmale_streifen/cstpw12.xml	stripes
schmale_streifen/cstpw13.xml	stripes
schmale_streifen/cstpw14.xml	stripes
schmale_streifen/cstpw15.xml	stripes
schmale_streifen/cstpw16.xml	stripes
schmale_streifen/cstpw17.xml	stripes
schmale_streifen/cstpw18.xml	stripes
schmale_streifen/cstpw19.xml	stripes
schmale_streifen/cstpw20.xml	stripes

ohne_streifen/cstpw1.xml	no_stripe
ohne_streifen/cstpw2.xml	no_stripe
ohne_streifen/cstpw3.xml	no_stripe
ohne_streifen/cstpw4.xml	no_stripe
ohne_streifen/cstpw21.xml	no_stripe
ohne_streifen/cstpw6.xml	no_stripe
ohne_streifen/cstpw7.xml	no_stripe
ohne_streifen/cstpw8.xml	no_stripe
ohne_streifen/cstpw9.xml	no_stripe
ohne_streifen/cstpw10.xml	no_stripe
ohne_streifen/cstpw11.xml	no_stripe
ohne_streifen/cstpw12.xml	no_stripe
ohne_streifen/cstpw13.xml	no_stripe
ohne_streifen/cstpw14.xml	no_stripe
ohne_streifen/cstpw15.xml	no_stripe
ohne_streifen/cstpw16.xml	no_stripe
ohne_streifen/cstpw17.xml	no_stripe
ohne_streifen/cstpw18.xml	no_stripe
ohne_streifen/cstpw19.xml	no_stripe
ohne_streifen/cstpw20.xml	no_stripe
ohne_streifen/cstpw22.xml	no_stripe